8
20
  XXXXXXXXX   XXXXXX 
X XXXXXXXXX X   XXXX 
X     XXXXX XXX XXXX 
XXX X XXXX  XXX XXXX 
XXX    XX  XXXX     
XXX XX X  XXXXX XXX 
XXXXXX X XXXXXX   X 
XXXXXX   XXXXXX XXXD 